//MAP CONVERTED BY dmm2tgm.py THIS HEADER COMMENT PREVENTS RECONVERSION, DO NOT REMOVE
"af" = (
/obj/structure/bed/pillowpile/black,
/obj/structure/bed/pillowpilefront,
/turf/simulated/floor/wood,
/area/space)
"bJ" = (
/turf/simulated/floor/carpet/turcarpet,
/area/space)
"bO" = (
/obj/structure/disposalpipe/junction{
	dir = 8;
	icon_state = "pipe-j2"
	},
/turf/simulated/floor/wood,
/area/space)
"bT" = (
/obj/structure/disposalpipe/segment,
/turf/simulated/floor/wood,
/area/space)
"bX" = (
/obj/machinery/cryopod/robot/door/gateway,
/turf/simulated/floor/tiled/techmaint,
/area/space)
"cq" = (
/obj/machinery/appliance/cooker/oven,
/turf/simulated/floor/tiled/white,
/area/space)
"cA" = (
/obj/structure/table/reinforced,
/obj/machinery/reagentgrinder{
	pixel_y = 10
	},
/turf/simulated/floor/tiled/white,
/area/space)
"cG" = (
/turf/simulated/shuttle/wall,
/area/space)
"cK" = (
/obj/structure/bed/chair/bar_stool,
/obj/structure/disposalpipe/junction{
	icon_state = "pipe-j2";
	dir = 2
	},
/turf/simulated/floor/tiled,
/area/space)
"cL" = (
/obj/machinery/conveyor{
	dir = 8;
	id = "bodieshitthefloor"
	},
/turf/simulated/floor/airless,
/area/space)
"dk" = (
/obj/structure/table/gamblingtable,
/turf/simulated/floor/wood,
/area/space)
"dF" = (
/turf/simulated/wall/turfpack/station,
/area/space)
"dU" = (
/obj/structure/disposalpipe/junction{
	dir = 8;
	icon_state = "pipe-j2"
	},
/turf/simulated/floor/tiled,
/area/space)
"dY" = (
/obj/structure/lattice,
/turf/space,
/area/space)
"eD" = (
/obj/structure/toilet{
	dir = 4
	},
/obj/machinery/disposal/wall{
	pixel_y = 35
	},
/obj/structure/disposalpipe/trunk{
	dir = 4
	},
/turf/simulated/floor/tiled/white,
/area/space)
"fg" = (
/obj/structure/fitness/weightlifter,
/turf/simulated/floor/boxing/gym,
/area/space)
"fy" = (
/obj/machinery/door/airlock/angled_bay/external/glass{
	dir = 4
	},
/turf/simulated/shuttle/floor,
/area/space)
"gE" = (
/obj/structure/bed/pillowpile/teal,
/obj/structure/bed/pillowpilefront/black,
/turf/simulated/floor/wood,
/area/space)
"hF" = (
/turf/simulated/floor/airless,
/area/space)
"hM" = (
/obj/machinery/embedded_controller/radio/simple_docking_controller/escape_pod{
	frequency = 1380;
	id_tag = "port_escape_pod";
	pixel_y = 24
	},
/obj/structure/bed/chair/bay/shuttle{
	dir = 8
	},
/turf/simulated/shuttle/floor,
/area/space)
"io" = (
/obj/structure/table/reinforced,
/obj/machinery/chemical_dispenser/bar_alc/full{
	dir = 8
	},
/turf/simulated/floor/tiled/white,
/area/space)
"ip" = (
/obj/structure/disposalpipe/segment{
	dir = 4
	},
/turf/simulated/floor/tiled/techmaint,
/area/space)
"is" = (
/turf/space,
/area/space)
"iy" = (
/obj/machinery/disposal/wall{
	dir = 1;
	pixel_y = -35
	},
/obj/structure/disposalpipe/trunk{
	dir = 4
	},
/turf/simulated/floor/tiled/techmaint,
/area/space)
"iC" = (
/obj/structure/cryofeed,
/turf/simulated/floor/tiled/freezer/cold,
/area/space)
"iG" = (
/turf/simulated/floor/tiled/freezer/cold,
/area/space)
"jq" = (
/obj/structure/sign/signnew/cryogenics,
/turf/simulated/wall/turfpack/station,
/area/space)
"jW" = (
/obj/machinery/computer/transhuman/resleeving{
	dir = 1
	},
/turf/simulated/floor/tiled/white,
/area/space)
"kE" = (
/obj/machinery/shower{
	dir = 4;
	pixel_y = -9
	},
/obj/structure/window/reinforced/polarized{
	dir = 1;
	id = "coffee"
	},
/turf/simulated/floor/tiled/freezer/cold,
/area/space)
"kR" = (
/obj/structure/sink/kitchen{
	dir = 8;
	pixel_x = -11
	},
/turf/simulated/floor/tiled/white,
/area/space)
"lD" = (
/obj/structure/disposalpipe/segment{
	dir = 4
	},
/turf/simulated/floor/carpet/turcarpet,
/area/space)
"mf" = (
/obj/structure/curtain/open/privacy{
	name = "shower curtain"
	},
/turf/simulated/floor/tiled/freezer/cold,
/area/space)
"mD" = (
/obj/effect/floor_decal/stairs{
	dir = 1
	},
/turf/space,
/area/space)
"mE" = (
/turf/simulated/floor/wood,
/area/space)
"np" = (
/turf/simulated/floor/tiled/techmaint,
/area/space)
"nD" = (
/obj/machinery/suit_storage_unit,
/turf/simulated/floor/tiled/techmaint,
/area/space)
"ou" = (
/obj/machinery/disposal/wall{
	dir = 8;
	pixel_y = 2;
	pixel_x = 30
	},
/obj/structure/disposalpipe/segment{
	dir = 2;
	icon_state = "pipe-c"
	},
/obj/structure/disposalpipe/trunk{
	dir = 1
	},
/turf/simulated/floor/wood,
/area/space)
"pH" = (
/obj/machinery/computer/security/telescreen/entertainment{
	pixel_y = 25;
	pixel_x = 16
	},
/obj/structure/table/woodentable,
/turf/simulated/floor/carpet/turcarpet,
/area/space)
"rv" = (
/obj/structure/sink{
	dir = 4;
	pixel_x = 12
	},
/obj/structure/disposalpipe/segment{
	dir = 8;
	icon_state = "pipe-c"
	},
/turf/simulated/floor/tiled/white,
/area/space)
"rC" = (
/obj/structure/shuttle/window,
/turf/simulated/shuttle/floor,
/area/space)
"rP" = (
/obj/structure/bed/chair/sofa{
	dir = 1
	},
/turf/simulated/floor/carpet/turcarpet,
/area/space)
"sk" = (
/obj/structure/railing{
	dir = 1
	},
/obj/structure/bed/chair/backed_red,
/turf/simulated/floor/wood,
/area/space)
"sm" = (
/obj/structure/disposalpipe/junction/yjunction{
	dir = 1
	},
/turf/simulated/floor/tiled/techmaint,
/area/space)
"ud" = (
/obj/machinery/mass_driver{
	dir = 1;
	id = "trash"
	},
/obj/structure/plasticflaps/mining,
/turf/simulated/floor/airless,
/area/space)
"uQ" = (
/obj/structure/table/reinforced,
/obj/machinery/microwave,
/turf/simulated/floor/tiled/white,
/area/space)
"vj" = (
/obj/structure/bed/chair/backed_red{
	dir = 8
	},
/turf/simulated/floor/wood,
/area/space)
"wh" = (
/obj/structure/sink{
	pixel_y = 16
	},
/obj/structure/disposalpipe/segment{
	dir = 4
	},
/turf/simulated/floor/tiled/white,
/area/space)
"wM" = (
/obj/machinery/disposal/wall{
	dir = 8;
	pixel_y = 2;
	pixel_x = 30
	},
/obj/structure/disposalpipe/trunk{
	dir = 1
	},
/turf/simulated/floor/wood,
/area/space)
"xt" = (
/obj/structure/disposalpipe/segment{
	dir = 4
	},
/turf/simulated/floor/tiled,
/area/space)
"xw" = (
/obj/structure/disposalpipe/segment,
/turf/simulated/floor/tiled,
/area/space)
"yO" = (
/obj/structure/bed/chair/sofa/corner{
	dir = 8
	},
/turf/simulated/floor/carpet/turcarpet,
/area/space)
"yX" = (
/obj/machinery/pointdefense{
	id_tag = "PD Main"
	},
/turf/simulated/floor/airless,
/area/space)
"zd" = (
/obj/structure/table/woodentable,
/turf/simulated/floor/tiled,
/area/space)
"zX" = (
/turf/simulated/floor/tiled/white,
/area/space)
"AB" = (
/obj/structure/disposalpipe/segment{
	dir = 2;
	icon_state = "pipe-c"
	},
/turf/simulated/floor/airless,
/area/space)
"AE" = (
/obj/structure/disposalpipe/segment,
/turf/simulated/floor/tiled/white,
/area/space)
"AT" = (
/obj/machinery/clonepod/transhuman,
/turf/simulated/floor/tiled/white,
/area/space)
"Bp" = (
/obj/structure/disposalpipe/segment{
	dir = 4
	},
/turf/simulated/floor/tiled/white,
/area/space)
"Bw" = (
/turf/simulated/floor/carpet/tealcarpet,
/area/space)
"BB" = (
/obj/structure/bed/pillowpile,
/obj/structure/bed/pillowpilefront/teal,
/turf/simulated/floor/wood,
/area/space)
"CC" = (
/turf/simulated/floor/tiled,
/area/space)
"CD" = (
/obj/machinery/computer/security/telescreen/entertainment{
	pixel_y = -19;
	pixel_x = -32
	},
/turf/simulated/floor/wood,
/area/space)
"CI" = (
/turf/simulated/floor/boxing/gym,
/area/space)
"CL" = (
/obj/structure/table/woodentable,
/turf/simulated/floor/carpet/turcarpet,
/area/space)
"CW" = (
/obj/structure/disposalpipe/segment,
/turf/simulated/floor/airless,
/area/space)
"DD" = (
/obj/structure/bed/chair/backed_red,
/obj/structure/disposalpipe/segment{
	dir = 8;
	icon_state = "pipe-c"
	},
/turf/simulated/floor/tiled,
/area/space)
"DT" = (
/obj/structure/closet/secure_closet/freezer/fridge,
/turf/simulated/floor/tiled/white,
/area/space)
"Fo" = (
/obj/machinery/disposal/wall{
	dir = 4;
	pixel_x = -24;
	plane = -34
	},
/obj/structure/disposalpipe/trunk{
	dir = 1
	},
/turf/simulated/floor/tiled,
/area/space)
"FH" = (
/obj/structure/bed/chair/modern_chair{
	dir = 1
	},
/obj/structure/bed/chair/backed_red{
	dir = 1
	},
/turf/simulated/floor/tiled,
/area/space)
"Gf" = (
/obj/machinery/conveyor{
	dir = 1;
	id = "cargounload"
	},
/obj/structure/window/reinforced{
	dir = 8
	},
/obj/structure/window/reinforced,
/obj/structure/disposaloutlet{
	dir = 1
	},
/obj/structure/disposalpipe/trunk,
/turf/simulated/floor/airless,
/area/space)
"Gt" = (
/obj/machinery/shower{
	dir = 1
	},
/turf/simulated/floor/tiled/freezer/cold,
/area/space)
"Hl" = (
/obj/machinery/disposal/wall{
	dir = 4;
	pixel_x = -30;
	pixel_y = 1
	},
/obj/structure/disposalpipe/trunk,
/turf/simulated/floor/wood,
/area/space)
"Hm" = (
/obj/structure/bed/chair/backed_red,
/obj/structure/disposalpipe/segment{
	dir = 4
	},
/turf/simulated/floor/tiled,
/area/space)
"Hs" = (
/turf/simulated/floor/carpet/purple,
/area/space)
"HM" = (
/obj/structure/bookcase{
	name = "Forbidden Knowledge"
	},
/turf/space,
/area/space)
"HY" = (
/obj/effect/wingrille_spawn/reinforced,
/turf/simulated/floor/airless,
/area/space)
"Ib" = (
/obj/structure/railing{
	dir = 1
	},
/obj/structure/railing{
	dir = 4
	},
/turf/simulated/floor/wood,
/area/space)
"IK" = (
/obj/structure/bed/chair/bay/shuttle{
	dir = 8
	},
/turf/simulated/shuttle/floor,
/area/space)
"Jg" = (
/obj/structure/bed/chair/sofa/right{
	dir = 8
	},
/turf/simulated/floor/carpet/turcarpet,
/area/space)
"JW" = (
/obj/machinery/conveyor{
	dir = 9;
	id = "mining_internal"
	},
/turf/simulated/floor/airless,
/area/space)
"Kc" = (
/obj/machinery/computer/transhuman/designer{
	dir = 1
	},
/turf/simulated/floor/tiled/white,
/area/space)
"Kk" = (
/obj/structure/lattice,
/obj/structure/lattice,
/turf/space,
/area/space)
"KZ" = (
/obj/structure/disposalpipe/segment{
	dir = 1;
	icon_state = "pipe-c"
	},
/turf/simulated/floor/wood,
/area/space)
"Ls" = (
/obj/structure/window/reinforced/polarized{
	dir = 1;
	id = "coffee"
	},
/turf/simulated/floor/tiled/freezer/cold,
/area/space)
"Mf" = (
/obj/structure/disposalpipe/segment,
/turf/simulated/floor/tiled/techmaint,
/area/space)
"MY" = (
/obj/structure/disposalpipe/segment{
	dir = 4;
	icon_state = "pipe-c"
	},
/turf/simulated/floor/wood,
/area/space)
"Ns" = (
/obj/structure/disposalpipe/junction/yjunction{
	dir = 8
	},
/turf/simulated/floor/tiled,
/area/space)
"Og" = (
/obj/structure/disposalpipe/junction{
	dir = 8
	},
/turf/simulated/floor/tiled,
/area/space)
"Pp" = (
/obj/structure/table/reinforced,
/turf/simulated/floor/tiled/white,
/area/space)
"Qd" = (
/obj/structure/disposalpipe/segment{
	dir = 4
	},
/turf/simulated/floor/airless,
/area/space)
"Qm" = (
/obj/structure/toilet{
	dir = 8
	},
/obj/machinery/disposal/wall{
	pixel_y = 35
	},
/obj/structure/disposalpipe/trunk{
	dir = 8
	},
/turf/simulated/floor/tiled/white,
/area/space)
"Qq" = (
/obj/machinery/cryopod{
	dir = 4
	},
/turf/simulated/floor/tiled/freezer/cold,
/area/space)
"Qr" = (
/obj/machinery/transhuman/resleever,
/turf/simulated/floor/tiled/white,
/area/space)
"RQ" = (
/obj/structure/bed/chair/sofa/right{
	dir = 1
	},
/turf/simulated/floor/carpet/turcarpet,
/area/space)
"RZ" = (
/obj/machinery/door/airlock/angled_bay/external/glass{
	dir = 4
	},
/turf/simulated/floor/airless,
/area/space)
"Ts" = (
/obj/machinery/door/blast/angled{
	dir = 4;
	id = "chapelmassdriver"
	},
/turf/simulated/wall/turfpack/station,
/area/space)
"TD" = (
/obj/structure/lattice,
/obj/machinery/pointdefense{
	id_tag = "PD Main"
	},
/turf/simulated/floor/airless,
/area/space)
"TI" = (
/obj/structure/shuttle/engine/propulsion{
	dir = 4
	},
/turf/simulated/shuttle/wall,
/area/space)
"UL" = (
/obj/structure/bed/chair/bar_stool,
/obj/structure/disposalpipe/segment,
/turf/simulated/floor/tiled,
/area/space)
"Vc" = (
/obj/machinery/door/airlock/maintenance/common,
/turf/simulated/floor/airless,
/area/space)
"VQ" = (
/obj/structure/fitness/punchingbag,
/turf/simulated/floor/boxing/gym,
/area/space)
"VU" = (
/obj/structure/bookcase{
	name = "bookcase (Reference)"
	},
/turf/space,
/area/space)
"WX" = (
/obj/structure/bookcase{
	name = "bookcase (Fiction)"
	},
/turf/space,
/area/space)
"Xv" = (
/obj/structure/bed/chair/backed_red{
	dir = 8
	},
/obj/structure/disposalpipe/segment{
	dir = 4;
	icon_state = "pipe-c"
	},
/turf/simulated/floor/wood,
/area/space)
"XO" = (
/obj/structure/bed/chair/backed_red{
	dir = 1
	},
/turf/simulated/floor/tiled,
/area/space)
"ZB" = (
/obj/structure/disposalpipe/segment{
	dir = 1;
	icon_state = "pipe-c"
	},
/turf/simulated/floor/airless,
/area/space)
"ZF" = (
/obj/machinery/door/airlock/maintenance/common,
/obj/structure/disposalpipe/segment,
/turf/simulated/floor/airless,
/area/space)

(1,1,1) = {"
is
is
is
is
is
is
is
is
is
is
is
is
is
is
is
is
is
is
is
is
is
is
is
is
is
is
is
is
is
is
is
is
is
is
is
is
is
is
is
is
is
is
is
is
is
is
is
is
is
is
"}
(2,1,1) = {"
is
is
is
is
is
is
is
is
is
is
is
is
is
is
is
is
is
is
is
is
is
is
is
is
is
is
is
is
is
is
is
is
is
is
is
is
is
is
is
is
is
is
is
is
is
is
is
is
is
is
"}
(3,1,1) = {"
is
is
is
is
is
is
is
is
is
is
is
is
is
is
is
is
is
is
is
is
is
is
is
is
is
is
is
is
is
is
is
is
is
is
is
is
is
is
is
is
is
is
is
is
is
is
is
is
is
is
"}
(4,1,1) = {"
is
is
is
is
is
is
is
is
is
is
is
is
is
is
is
is
is
is
is
is
is
is
is
is
is
is
is
is
is
is
is
is
is
is
is
is
is
is
is
is
is
is
is
is
is
is
is
is
is
is
"}
(5,1,1) = {"
is
is
is
is
is
is
is
is
is
is
is
is
is
is
is
is
is
is
is
is
is
is
is
is
is
is
is
is
is
is
is
is
is
is
is
is
is
is
is
is
is
is
is
is
is
is
is
is
is
is
"}
(6,1,1) = {"
is
is
is
is
is
is
is
is
is
is
is
is
is
is
is
is
is
is
is
is
is
is
is
is
is
is
is
is
is
is
is
is
is
is
is
is
is
is
is
is
is
is
is
is
is
is
is
is
is
is
"}
(7,1,1) = {"
is
is
is
is
is
is
is
is
is
is
is
is
is
is
is
is
is
is
is
is
is
is
is
is
is
is
is
is
is
is
is
is
is
is
is
is
is
is
is
is
is
is
is
is
is
is
is
is
is
is
"}
(8,1,1) = {"
is
is
is
is
is
is
is
is
is
is
is
is
is
is
is
is
is
is
is
is
is
is
is
is
is
is
is
is
is
is
is
is
is
is
is
is
is
is
is
is
is
is
is
is
is
is
is
is
is
is
"}
(9,1,1) = {"
is
is
is
is
is
is
is
is
is
is
is
is
is
is
is
is
is
is
is
is
is
is
is
is
is
is
is
is
is
is
is
is
is
is
is
is
is
is
is
is
is
is
is
is
is
is
is
is
is
is
"}
(10,1,1) = {"
is
is
is
is
is
is
is
is
is
is
is
is
is
is
is
is
is
is
is
is
is
is
is
is
is
is
is
is
is
is
is
is
is
is
is
is
is
is
is
is
is
is
is
is
is
is
is
is
is
is
"}
(11,1,1) = {"
is
is
is
is
is
is
is
is
is
is
is
is
is
is
is
is
is
is
is
is
is
is
is
is
is
is
is
is
is
is
is
is
is
is
is
is
is
is
is
is
is
is
is
is
is
is
is
is
is
is
"}
(12,1,1) = {"
is
is
is
is
is
is
is
is
is
is
is
is
is
is
is
is
is
is
is
is
is
is
is
is
is
is
is
is
is
is
is
is
is
is
is
is
is
is
is
is
is
is
is
is
is
is
is
is
is
is
"}
(13,1,1) = {"
is
is
is
is
is
is
is
is
is
is
is
is
is
is
is
is
is
is
is
is
is
is
is
is
is
is
is
is
is
is
is
is
is
is
is
is
is
is
is
is
is
is
is
is
is
is
is
is
is
is
"}
(14,1,1) = {"
is
is
is
is
is
is
is
is
is
is
is
is
is
is
is
is
is
is
is
is
is
is
is
is
is
is
is
is
is
is
is
is
is
is
is
is
is
is
is
is
is
is
is
is
is
is
is
is
is
is
"}
(15,1,1) = {"
is
is
is
is
is
is
is
is
is
is
is
is
is
is
is
is
is
is
is
is
is
is
is
is
is
is
is
is
is
is
is
is
is
is
is
is
is
is
is
is
is
is
is
is
is
is
is
is
is
is
"}
(16,1,1) = {"
is
is
is
is
is
is
is
is
is
is
is
is
is
is
is
is
is
is
is
is
is
is
is
is
is
is
is
is
is
is
is
is
is
is
is
is
is
is
is
is
is
is
is
is
is
is
is
is
is
is
"}
(17,1,1) = {"
is
is
is
is
is
is
is
is
is
is
is
is
is
is
is
is
is
is
is
is
is
is
is
is
is
is
is
is
is
is
is
is
is
is
is
is
is
is
is
is
is
is
is
is
is
is
is
is
is
is
"}
(18,1,1) = {"
is
is
is
is
is
is
is
is
is
is
is
is
is
is
is
is
is
is
is
is
is
is
is
is
is
is
is
is
is
is
is
is
is
is
is
is
is
is
is
is
is
is
is
is
is
is
is
is
is
is
"}
(19,1,1) = {"
is
is
is
is
is
is
is
is
is
is
is
is
is
is
is
is
is
is
is
is
is
is
is
is
is
is
is
is
is
is
is
is
is
is
is
is
is
is
is
is
is
is
is
is
is
is
is
is
is
is
"}
(20,1,1) = {"
is
is
is
is
is
is
is
is
is
is
is
is
is
is
is
is
is
is
is
is
is
is
is
is
is
is
is
is
is
is
is
is
is
is
is
is
is
is
is
is
is
is
is
is
is
is
is
is
is
is
"}
(21,1,1) = {"
is
is
is
is
is
is
is
is
is
is
is
is
is
is
is
is
is
is
is
is
is
is
is
is
is
is
is
is
is
is
is
is
is
is
is
is
is
is
is
is
is
is
is
is
is
is
is
is
is
is
"}
(22,1,1) = {"
is
is
is
is
is
is
is
is
is
is
is
is
is
is
is
is
is
is
is
is
is
is
is
is
is
is
is
is
is
is
is
is
is
is
is
is
is
is
is
is
is
is
is
is
is
is
is
is
is
is
"}
(23,1,1) = {"
is
is
is
is
is
is
is
is
is
is
is
is
is
is
is
is
is
is
is
is
is
is
is
is
is
is
is
is
is
is
is
is
is
is
is
is
is
is
is
is
is
is
is
is
is
is
is
is
is
is
"}
(24,1,1) = {"
is
is
is
is
is
is
is
is
is
is
is
is
is
is
is
is
is
is
is
is
is
is
is
is
is
is
is
is
is
is
is
is
is
is
is
is
is
is
is
is
is
is
is
is
is
is
is
is
is
is
"}
(25,1,1) = {"
is
is
is
is
is
is
is
is
is
is
is
is
is
is
is
is
is
is
is
is
is
is
is
is
is
is
is
is
is
is
is
is
is
is
is
is
is
is
is
is
is
is
is
is
is
is
is
is
is
is
"}
(26,1,1) = {"
is
is
is
is
is
is
is
is
is
is
is
is
is
is
is
is
is
is
is
is
is
is
is
is
is
is
is
is
is
is
is
is
is
is
is
is
is
is
is
is
is
is
is
is
is
is
is
is
is
is
"}
(27,1,1) = {"
is
is
is
is
is
is
is
is
is
is
is
is
is
is
is
is
is
is
is
is
is
is
is
is
is
is
is
is
is
is
is
is
is
is
is
is
is
is
is
is
is
is
is
is
is
is
is
is
is
is
"}
(28,1,1) = {"
is
is
is
is
is
is
is
is
is
is
is
is
is
is
is
is
is
is
is
is
is
is
is
is
is
is
is
is
is
is
is
is
is
is
is
is
is
is
is
is
is
is
is
is
is
is
is
is
is
is
"}
(29,1,1) = {"
is
is
is
is
is
is
is
is
is
is
is
is
is
is
is
is
is
is
is
is
is
is
is
is
is
is
is
is
is
is
is
is
is
is
is
is
is
is
is
is
is
is
is
is
is
is
is
is
is
is
"}
(30,1,1) = {"
is
is
is
is
is
is
is
is
is
is
is
is
is
is
is
is
is
is
is
is
is
is
is
is
is
is
is
is
is
is
is
is
is
is
is
is
is
is
is
is
is
is
is
is
is
is
is
is
is
is
"}
(31,1,1) = {"
is
is
is
is
is
is
is
is
is
is
is
is
is
is
is
is
is
is
is
is
is
is
is
is
is
is
is
is
is
is
is
is
is
is
is
is
is
is
is
is
is
is
is
is
is
is
is
is
is
is
"}
(32,1,1) = {"
is
is
is
is
is
is
is
is
is
is
is
is
is
is
is
is
is
is
is
is
is
is
is
is
is
is
is
is
is
is
is
is
is
is
is
is
is
is
is
is
is
is
is
is
is
is
is
is
is
is
"}
(33,1,1) = {"
is
is
is
is
is
is
is
is
is
is
is
is
is
is
is
is
is
is
is
is
is
is
is
is
is
is
is
is
is
is
is
is
is
is
is
is
is
is
is
is
is
is
is
is
is
is
is
is
is
is
"}
(34,1,1) = {"
is
is
is
is
is
is
is
is
is
is
is
is
is
is
is
is
is
is
is
is
is
is
is
is
is
is
is
is
is
is
is
is
is
is
is
is
is
is
is
is
is
is
is
is
is
is
is
is
is
is
"}
(35,1,1) = {"
is
is
is
is
is
is
is
is
is
is
is
is
is
is
is
is
is
is
is
is
is
is
is
is
is
is
is
is
is
is
is
is
is
is
is
is
is
is
is
is
is
is
is
is
is
is
is
is
is
is
"}
(36,1,1) = {"
is
is
is
is
is
is
is
is
is
is
is
is
is
is
is
is
is
is
is
is
is
is
is
is
is
is
is
is
is
is
is
is
is
is
is
is
is
is
is
is
is
is
is
is
is
is
is
is
is
is
"}
(37,1,1) = {"
is
is
is
is
is
is
is
is
is
is
is
is
is
is
is
is
is
is
is
is
is
is
is
is
is
is
is
is
is
is
is
is
is
is
is
is
is
is
is
is
is
is
is
is
is
is
is
is
is
is
"}
(38,1,1) = {"
is
is
is
is
is
is
is
is
is
is
is
is
is
is
is
is
is
is
is
is
is
is
is
is
is
is
is
is
is
is
is
is
is
is
is
is
is
is
is
is
is
is
is
is
is
is
is
is
is
is
"}
(39,1,1) = {"
is
is
is
is
is
is
is
is
is
is
is
is
is
is
is
is
is
is
is
is
is
is
is
is
is
is
is
is
is
is
is
is
is
is
is
is
is
is
is
is
is
is
is
is
is
is
is
is
is
is
"}
(40,1,1) = {"
is
is
is
is
is
is
is
is
is
is
is
is
is
is
is
is
is
is
is
is
is
is
is
is
is
is
is
is
is
is
is
is
is
is
is
is
is
is
is
is
is
is
is
is
is
is
is
is
is
is
"}
(41,1,1) = {"
is
is
is
is
is
is
is
is
is
is
is
is
is
is
is
is
is
is
is
is
is
is
is
is
is
is
is
is
is
is
is
is
is
is
is
is
is
is
is
is
is
is
is
is
is
is
is
is
is
is
"}
(42,1,1) = {"
is
is
is
is
is
is
is
is
is
is
is
is
is
is
is
is
is
is
is
is
is
is
is
is
is
is
is
is
is
is
is
is
is
is
is
is
is
is
is
is
is
is
is
is
is
is
is
is
is
is
"}
(43,1,1) = {"
is
is
is
is
is
is
is
is
is
is
is
is
is
is
is
is
is
is
is
is
is
is
is
is
is
is
is
is
is
is
is
is
is
is
is
is
is
is
is
is
is
is
is
is
is
is
is
is
is
is
"}
(44,1,1) = {"
is
is
is
is
is
is
is
is
is
is
is
is
is
is
is
is
is
is
is
is
is
is
is
is
is
is
is
is
is
is
is
is
is
is
is
is
is
is
is
is
is
is
is
is
is
is
is
is
is
is
"}
(45,1,1) = {"
is
is
is
is
is
is
is
is
is
is
is
is
is
is
is
is
is
is
is
is
is
is
is
is
is
is
is
is
is
is
is
is
is
is
is
is
is
is
is
is
is
is
is
is
is
is
is
is
is
is
"}
(46,1,1) = {"
is
is
is
is
is
is
is
is
is
is
is
is
is
is
is
is
is
is
is
is
is
is
is
is
is
is
is
is
is
is
is
is
is
is
is
is
is
is
is
is
is
is
is
is
is
is
is
is
is
is
"}
(47,1,1) = {"
is
is
is
is
is
is
is
is
is
is
is
is
is
is
is
is
is
is
is
is
is
is
is
is
is
is
is
is
is
is
is
is
is
is
is
is
is
is
is
is
is
is
is
is
is
is
is
is
is
is
"}
(48,1,1) = {"
is
is
is
is
is
is
is
is
is
is
is
is
is
is
is
is
is
is
is
is
is
is
is
is
is
is
is
is
is
is
is
is
is
is
is
is
is
is
is
is
is
is
is
is
is
is
is
is
is
is
"}
(49,1,1) = {"
is
is
is
is
is
is
is
is
is
is
is
is
is
is
is
is
is
is
is
is
is
is
is
is
is
is
is
is
is
is
is
is
is
is
is
is
is
is
is
is
is
is
is
is
is
is
is
is
is
is
"}
(50,1,1) = {"
is
is
is
is
is
is
is
is
is
is
is
is
is
is
is
is
is
is
is
is
is
is
is
is
is
is
is
is
is
is
is
is
is
is
is
is
is
is
is
is
is
is
is
is
is
is
is
is
is
is
"}

(1,1,2) = {"
is
is
is
is
is
is
is
is
is
is
is
is
is
is
is
is
is
is
is
is
is
is
is
is
is
is
is
is
is
is
is
is
is
is
is
is
is
is
is
is
is
is
is
is
is
is
is
is
is
is
"}
(2,1,2) = {"
is
is
is
is
is
is
is
is
is
is
is
is
is
is
is
is
is
is
is
is
is
is
is
is
is
is
is
is
is
is
is
is
is
is
is
is
is
is
is
is
is
is
is
is
is
is
is
is
is
is
"}
(3,1,2) = {"
is
is
is
is
is
is
is
is
is
is
is
is
is
is
is
is
is
is
is
is
is
is
is
is
is
is
is
is
is
is
is
is
is
is
is
is
is
is
is
is
is
is
is
is
is
is
is
is
is
is
"}
(4,1,2) = {"
is
is
is
is
is
is
is
is
is
is
is
is
is
is
is
is
is
is
is
is
is
is
is
is
is
is
is
is
is
is
is
is
is
is
is
is
is
is
is
is
is
is
is
is
is
is
is
is
is
is
"}
(5,1,2) = {"
is
is
is
is
is
is
is
is
is
is
is
is
is
is
is
is
is
is
is
is
is
is
is
is
is
is
is
is
is
is
is
is
is
is
is
is
is
is
is
is
is
is
is
is
is
is
is
is
is
is
"}
(6,1,2) = {"
is
is
is
is
is
is
is
is
is
is
is
is
is
is
is
is
is
is
is
is
is
is
is
is
is
is
is
is
is
is
is
is
is
is
is
is
is
is
is
is
is
is
is
is
is
is
is
is
is
is
"}
(7,1,2) = {"
is
is
is
is
is
is
is
is
is
is
is
is
is
is
is
is
is
is
is
is
is
is
is
is
is
is
is
is
is
is
is
is
is
is
is
is
is
is
is
is
is
is
is
is
is
is
is
is
is
is
"}
(8,1,2) = {"
is
is
is
is
is
is
is
is
is
is
is
is
is
is
is
is
is
is
is
is
is
is
is
is
is
is
is
is
is
is
is
is
is
is
is
is
is
is
is
is
is
is
is
is
is
is
is
is
is
is
"}
(9,1,2) = {"
is
is
is
is
is
is
is
is
is
is
is
is
is
is
is
is
is
is
is
is
is
is
is
is
is
is
is
is
is
is
is
is
is
is
is
is
is
is
is
is
is
is
is
is
is
is
is
is
is
is
"}
(10,1,2) = {"
is
is
is
is
is
is
is
is
is
is
is
is
is
is
is
is
is
is
is
is
cG
rC
cG
is
is
is
is
dF
np
HY
dF
is
is
is
is
is
is
is
is
is
is
is
is
is
is
is
is
is
is
is
"}
(11,1,2) = {"
is
is
is
is
is
is
is
is
is
is
is
is
is
is
is
is
is
is
is
is
cG
hM
cG
is
dY
dY
dY
dF
np
np
dF
is
is
is
is
is
is
is
is
is
is
is
is
is
is
is
is
is
is
is
"}
(12,1,2) = {"
is
is
is
is
is
is
is
is
is
is
is
is
is
is
is
is
is
is
is
is
cG
IK
cG
is
dY
yX
dY
dF
np
HY
dF
is
is
is
is
is
is
is
is
is
is
is
is
is
is
is
is
is
is
is
"}
(13,1,2) = {"
is
is
is
is
is
is
is
is
is
is
is
is
is
is
is
is
is
is
is
dF
TI
fy
TI
dF
dY
dY
dY
dF
np
np
dF
is
is
is
is
is
is
is
is
is
is
is
is
is
is
is
is
is
is
is
"}
(14,1,2) = {"
is
is
is
is
is
is
is
is
is
is
is
is
is
is
is
is
is
is
is
dF
dF
RZ
dF
dF
HY
HY
HY
dF
np
np
dF
is
is
is
is
is
is
is
is
is
is
is
is
is
is
is
is
is
is
is
"}
(15,1,2) = {"
is
is
is
is
is
is
is
is
is
is
is
is
is
is
is
is
is
is
is
HY
hF
hF
hF
hF
hF
hF
hF
Vc
np
np
Vc
is
is
is
is
is
is
is
is
is
is
is
is
is
is
is
is
is
is
is
"}
(16,1,2) = {"
is
is
is
is
is
is
is
is
is
is
is
is
is
is
is
is
is
is
is
dF
dF
Vc
dF
dF
dF
dF
dF
dF
np
np
dF
dF
is
is
is
is
is
is
is
is
is
is
is
is
is
is
is
is
is
is
"}
(17,1,2) = {"
is
is
is
is
is
is
is
is
is
is
is
is
is
is
is
is
is
is
is
Ts
ud
hF
hF
dF
np
np
np
HY
np
np
nD
dF
is
is
is
is
is
is
is
is
is
is
is
is
is
is
is
is
is
is
"}
(18,1,2) = {"
is
is
is
is
is
is
is
is
is
is
is
is
is
is
is
is
dY
dY
dY
dF
cL
hF
hF
dF
np
bX
np
np
np
np
nD
dF
is
is
is
is
is
is
is
is
is
is
is
is
is
is
is
is
is
is
"}
(19,1,2) = {"
is
is
is
is
is
is
is
is
is
is
is
is
is
is
is
is
dY
TD
dY
HY
JW
Gf
ZB
dF
np
np
np
HY
np
np
nD
dF
is
is
is
is
is
is
is
is
is
is
is
is
is
is
is
is
is
is
"}
(20,1,2) = {"
is
is
is
is
is
is
is
is
is
is
is
is
is
is
is
is
dY
Kk
dY
dF
dF
dF
Qd
dF
dF
dF
dF
dF
np
iy
dF
dF
is
is
is
is
is
is
is
is
is
is
is
is
is
is
is
is
is
is
"}
(21,1,2) = {"
is
is
is
is
is
is
is
is
is
is
is
is
is
is
is
is
is
is
is
dF
hF
hF
AB
CW
CW
CW
CW
ZF
Mf
sm
Vc
hF
hF
is
is
is
is
is
is
is
is
is
is
is
is
is
is
is
is
is
"}
(22,1,2) = {"
is
is
is
is
is
is
is
is
is
is
is
is
is
is
is
is
is
HY
HY
dF
dF
dF
dF
dF
dF
dF
dF
dF
HY
ip
dF
dF
dF
is
is
is
is
is
is
is
is
is
is
is
is
is
is
is
is
is
"}
(23,1,2) = {"
is
is
is
is
is
is
is
is
is
is
is
is
is
is
is
is
HY
HY
mE
CD
BB
af
WX
dF
cq
kR
uQ
cA
CC
dU
Fo
CC
dF
is
is
is
is
is
is
is
is
is
is
is
is
is
is
is
is
is
"}
(24,1,2) = {"
is
is
is
is
is
is
is
is
is
is
is
is
is
is
is
HY
HY
CI
sk
dk
dk
gE
HM
dF
DT
zX
zX
zX
CC
Hm
zd
FH
dF
is
is
is
is
is
is
is
is
is
is
is
is
is
is
is
is
is
"}
(25,1,2) = {"
is
is
is
is
is
is
is
is
is
is
is
is
is
is
is
HY
fg
CI
Ib
vj
Xv
KZ
VU
dF
dF
io
Pp
Pp
CC
Hm
zd
XO
dF
is
is
is
is
is
is
is
is
is
is
is
is
is
is
is
is
is
"}
(26,1,2) = {"
is
is
is
is
is
is
is
is
is
is
is
is
is
is
is
dF
VQ
CI
mD
mE
bO
ou
bT
xw
xw
xw
cK
UL
xw
DD
zd
XO
dF
is
is
is
is
is
is
is
is
is
is
is
is
is
is
is
is
is
"}
(27,1,2) = {"
is
is
is
is
is
is
is
is
is
is
is
is
is
is
is
dF
dF
dF
dF
dF
xt
dF
dF
dF
dF
CC
xt
CC
CC
CC
CC
CC
dF
is
is
is
is
is
is
is
is
is
is
is
is
is
is
is
is
is
"}
(28,1,2) = {"
is
is
is
is
is
is
is
is
is
is
is
is
is
is
is
HY
mE
mE
Hl
bT
Og
dF
eD
kE
dF
pH
lD
bJ
CL
RQ
dF
is
dF
is
is
is
is
is
is
is
is
is
is
is
is
is
is
is
is
is
"}
(29,1,2) = {"
is
is
is
is
is
is
is
is
is
is
is
is
is
is
is
HY
mE
mE
mE
dF
dU
AE
rv
mf
dF
CL
lD
bJ
CL
rP
dF
is
is
is
is
is
is
is
is
is
is
is
is
is
is
is
is
is
is
is
"}
(30,1,2) = {"
is
is
is
is
is
is
is
is
is
is
is
is
is
is
is
dF
dF
dF
dF
dF
xt
dF
dF
dF
dF
dF
lD
bJ
Jg
yO
dF
is
is
is
is
is
is
is
is
is
is
is
is
is
is
is
is
is
is
is
"}
(31,1,2) = {"
is
is
is
is
is
is
is
is
is
is
is
is
is
is
is
HY
mE
Hs
Hs
dF
xt
dF
Bw
Bw
mE
dF
Bp
dF
dF
dF
dF
is
is
is
is
is
is
is
is
is
is
is
is
is
is
is
is
is
is
is
"}
(32,1,2) = {"
is
is
is
is
is
is
is
is
is
is
is
is
is
is
is
HY
mE
Hs
Hs
dF
xt
dF
Bw
Bw
mE
dF
wh
mf
Gt
dF
is
is
is
is
is
is
is
is
is
is
is
is
is
is
is
is
is
is
is
is
"}
(33,1,2) = {"
is
is
is
is
is
is
is
is
is
is
is
is
is
is
is
HY
MY
bT
KZ
dF
xt
dF
mE
mE
mE
dF
Qm
Ls
Gt
dF
is
is
is
is
is
is
is
is
is
is
is
is
is
is
is
is
is
is
is
is
"}
(34,1,2) = {"
is
is
is
is
is
is
is
is
is
is
is
is
is
is
is
HY
bO
bT
ou
bT
Ns
bT
wM
mE
mE
dF
dF
dF
dF
dF
is
is
is
is
is
is
is
is
is
is
is
is
is
is
is
is
is
is
is
is
"}
(35,1,2) = {"
is
is
is
is
is
is
is
is
is
is
is
is
is
is
is
dF
Bp
dF
dF
dF
dF
dF
dF
dF
dF
dF
is
is
is
is
is
is
is
is
is
is
is
is
is
is
is
is
is
is
is
is
is
is
is
is
"}
(36,1,2) = {"
is
is
is
is
is
is
is
is
is
is
is
is
is
is
is
HY
zX
zX
zX
zX
Kc
HY
iC
iC
iC
dF
is
is
is
is
is
is
is
is
is
is
is
is
is
is
is
is
is
is
is
is
is
is
is
is
"}
(37,1,2) = {"
is
is
is
is
is
is
is
is
is
is
is
is
is
is
is
HY
zX
zX
zX
zX
jW
HY
Qq
Qq
Qq
jq
is
is
is
is
is
is
is
is
is
is
is
is
is
is
is
is
is
is
is
is
is
is
is
is
"}
(38,1,2) = {"
is
is
is
is
is
is
is
is
is
is
is
is
is
is
is
HY
HY
zX
zX
zX
Qr
HY
iG
iG
iG
iG
is
is
is
is
is
is
is
is
is
is
is
is
is
is
is
is
is
is
is
is
is
is
is
is
"}
(39,1,2) = {"
is
is
is
is
is
is
is
is
is
is
is
is
is
is
is
is
HY
HY
zX
zX
AT
HY
HY
HY
HY
dF
is
is
is
is
is
is
is
is
is
is
is
is
is
is
is
is
is
is
is
is
is
is
is
is
"}
(40,1,2) = {"
is
is
is
is
is
is
is
is
is
is
is
is
is
is
is
is
is
HY
HY
zX
zX
is
is
is
is
is
is
is
is
is
is
is
is
is
is
is
is
is
is
is
is
is
is
is
is
is
is
is
is
is
"}
(41,1,2) = {"
is
is
is
is
is
is
is
is
is
is
is
is
is
is
is
is
is
is
HY
HY
HY
dF
dF
dF
dF
dF
is
is
is
is
is
is
is
is
is
is
is
is
is
is
is
is
is
is
is
is
is
is
is
is
"}
(42,1,2) = {"
is
is
is
is
is
is
is
is
is
is
is
is
is
is
is
is
is
is
is
is
is
is
is
is
is
is
is
is
is
is
is
is
is
is
is
is
is
is
is
is
is
is
is
is
is
is
is
is
is
is
"}
(43,1,2) = {"
is
is
is
is
is
is
is
is
is
is
is
is
is
is
is
is
is
is
is
is
is
is
is
is
is
is
is
is
is
is
is
is
is
is
is
is
is
is
is
is
is
is
is
is
is
is
is
is
is
is
"}
(44,1,2) = {"
is
is
is
is
is
is
is
is
is
is
is
is
is
is
is
is
is
is
is
is
is
is
is
is
is
is
is
is
is
is
is
is
is
is
is
is
is
is
is
is
is
is
is
is
is
is
is
is
is
is
"}
(45,1,2) = {"
is
is
is
is
is
is
is
is
is
is
is
is
is
is
is
is
is
is
is
is
is
is
is
is
is
is
is
is
is
is
is
is
is
is
is
is
is
is
is
is
is
is
is
is
is
is
is
is
is
is
"}
(46,1,2) = {"
is
is
is
is
is
is
is
is
is
is
is
is
is
is
is
is
is
is
is
is
is
is
is
is
is
is
is
is
is
is
is
is
is
is
is
is
is
is
is
is
is
is
is
is
is
is
is
is
is
is
"}
(47,1,2) = {"
is
is
is
is
is
is
is
is
is
is
is
is
is
is
is
is
is
is
is
is
is
is
is
is
is
is
is
is
is
is
is
is
is
is
is
is
is
is
is
is
is
is
is
is
is
is
is
is
is
is
"}
(48,1,2) = {"
is
is
is
is
is
is
is
is
is
is
is
is
is
is
is
is
is
is
is
is
is
is
is
is
is
is
is
is
is
is
is
is
is
is
is
is
is
is
is
is
is
is
is
is
is
is
is
is
is
is
"}
(49,1,2) = {"
is
is
is
is
is
is
is
is
is
is
is
is
is
is
is
is
is
is
is
is
is
is
is
is
is
is
is
is
is
is
is
is
is
is
is
is
is
is
is
is
is
is
is
is
is
is
is
is
is
is
"}
(50,1,2) = {"
is
is
is
is
is
is
is
is
is
is
is
is
is
is
is
is
is
is
is
is
is
is
is
is
is
is
is
is
is
is
is
is
is
is
is
is
is
is
is
is
is
is
is
is
is
is
is
is
is
is
"}
